Sor
Resistance: Subject gains +1 on saving throws.
Acid Splash: Orb deals 1d3 acid damage.
Detect Poison: Detects poison in one creature or small object.
Detect Magic: Detects spells and magic items within 60 ft.
Read Magic: Read scrolls and spellbooks.
Daze: Humanoid creature of 4 HD or less loses next action.
Dancing Lights: Creates torches or other lights.
Flare: Dazzles one creature (–1 on attack rolls).
Light: Object shines like a torch.
Ray of Frost: Ray deals 1d3 cold damage.
Ghost Sound: Figment sounds.
Disrupt Undead: Deals 1d6 damage to one undead.
Touch of Fatigue: Touch attack fatigues target.
Mage Hand: 5-pound telekinesis.
Mending: Makes minor repairs on an object.
Message: Whispered conversation at distance.
Open/Close: Opens or closes small or light things.
Arcane Mark: Inscribes a personal rune (visible or invisible).
Prestidigitation: Performs minor tricks.
Alarm: Wards an area for 2 hours/level.
Endure Elements: Exist comfortably in hot or cold environments.
Hold Portal: Holds door shut.
Protection from Chaos: +2 to AC and saves, counter mind control, hedge out elementals and outsiders.
Protection from Evil: +2 to AC and saves, counter mind control, hedge out elementals and outsiders.
Protection from Good: +2 to AC and saves, counter mind control, hedge out elementals and outsiders.
Protection from Law: +2 to AC and saves, counter mind control, hedge out elementals and outsiders.
Shield: Invisible disc gives +4 to AC, blocks magic missiles.
Grease: Makes 10-ft. square or one object slippery.
Mage Armor: Gives subject +4 armor bonus.
Mount: Summons riding horse for 2 hours/level.
Obscuring Mist: Fog surrounds you.
Summon Monster I: Calls extraplanar creature to fight for you.
Unseen Servant: Invisible force obeys your commands.
Comprehend Languages: You understand all spoken and written languages.
Detect Secret Doors: Reveals hidden doors within 60 ft.
Detect Undead: Reveals undead within 60 ft.
IdentifyM: Determines properties of magic item.
True Strike: +20 on your next attack roll.
Charm Person: Makes one person your friend.
Hypnotism: Fascinates 2d4 HD of creatures.
Sleep: Puts 4 HD of creatures into magical slumber.
Burning Hands: 1d4/level fire damage (max 5d4).
Floating Disk: Creates 3-ft.-diameter horizontal disk that holds 100 lb./level.
Magic Missile: 1d4+1 damage; +1 missile per two levels above 1st (max 5).
Shocking Grasp: Touch delivers 1d6/level electricity damage (max 5d6).
Color Spray: Knocks unconscious, blinds, and/or stuns weak creatures.
Disguise Self: Changes your appearance.
Magic Aura: Alters object’s magic aura.
Silent Image: Creates minor illusion of your design.
Ventriloquism: Throws voice for 1 min./level.
Cause Fear: One creature of 5 HD or less flees for 1d4 rounds.
Chill Touch: One touch/level deals 1d6 damage and possibly 1 Str damage.
Ray of Enfeeblement: Ray deals 1d6 +1 per two levels Str damage.
Animate Rope: Makes a rope move at your command.
Enlarge Person: Humanoid creature doubles in size.
Erase: Mundane or magical writing vanishes.
Expeditious Retreat: Your speed increases by 30 ft.
Feather Fall: Objects or creatures fall slowly.
Jump: Subject gets bonus on Jump checks.
Magic Weapon: Weapon gains +1 bonus.
Reduce Person: Humanoid creature halves in size.
Arcane LockM: Magically locks a portal or chest.
Obscure Object: Masks object against scrying.
Protection from Arrows: Subject immune to most ranged attacks.
Resist Energy: Ignores first 10 (or more) points of damage/attack from specified energy type.
Acid Arrow: Ranged touch attack; 2d4 damage for 1 round +1 round/three levels.
Fog Cloud: Fog obscures vision.
Glitterdust: Blinds creatures, outlines invisible creatures.
Summon Monster II: Calls extraplanar creature to fight for you.
Summon Swarm: Summons swarm of bats, rats, or spiders.
Web: Fills 20-ft.-radius spread with sticky spiderwebs.
Detect Thoughts: Allows “listening” to surface thoughts.
Locate Object: Senses direction toward object (specific or type).
See Invisibility: Reveals invisible creatures or objects.
Daze Monster: Living creature of 6 HD or less loses next action.
Hideous Laughter: Subject loses actions for 1 round/level.
Touch of Idiocy: Subject takes 1d6 points of Int, Wis, and Cha damage.
Continual FlameM: Makes a permanent, heatless torch.
Darkness: 20-ft. radius of supernatural shadow.
Flaming Sphere: Creates rolling ball of fire, 2d6 damage, lasts 1 round/level.
Gust of Wind: Blows away or knocks down smaller creatures.
Scorching Ray: Ranged touch attack deals 4d6 fire damage, +1 ray/four levels (max 3).
Shatter: Sonic vibration damages objects or crystalline creatures.
Blur: Attacks miss subject 20% of the time.
Hypnotic Pattern: Fascinates (2d4 + level) HD of creatures.
Invisibility: Subject is invisible for 1 min./level or until it attacks.
Magic MouthM: Speaks once when triggered.
Minor Image: As silent image, plus some sound.
Mirror Image: Creates decoy duplicates of you (1d4 +1 per three levels, max 8).
Misdirection: Misleads divinations for one creature or object.
Phantom TrapM: Makes item seem trapped.
Blindness/Deafness: Makes subject blinded or deafened.
Command Undead: Undead creature obeys your commands.
False Life: Gain 1d10 temporary hp +1/level (max +10).
Ghoul Touch: Paralyzes one subject, which exudes stench that makes those nearby sickened.
Scare: Panics creatures of less than 6 HD.
Spectral Hand: Creates disembodied glowing hand to deliver touch attacks.
Alter Self: Assume form of a similar creature.
Bear's Endurance: Subject gains +4 to Con for 1 min./level.
Bull's Strength: Subject gains +4 to Str for 1 min./level.
Cat's Grace: Subject gains +4 to Dex for 1 min./level.
Darkvision: See 60 ft. in total darkness.
Eagle's Splendor: Subject gains +4 to Cha for 1 min./level.
Fox's Cunning: Subject gains +4 Int for 1 min./level.
Knock: Opens locked or magically sealed door.
Levitate: Subject moves up and down at your direction.
Owl's Wisdom: Subject gains +4 to Wis for 1 min./level.
Pyrotechnics: Turns fire into blinding light or choking smoke.
Rope Trick: As many as eight creatures hide in extradimensional space.
Spider Climb: Grants ability to walk on walls and ceilings.
Whispering Wind: Sends a short message 1 mile/level.
Dispel Magic: Cancels magical spells and effects.
Explosive Runes: Deals 6d6 damage when read.
Magic Circle against Chaos: As protection spells, but 10-ft. radius and 10 min./level.
Magic Circle against Evil: As protection spells, but 10-ft. radius and 10 min./level.
Magic Circle against Good: As protection spells, but 10-ft. radius and 10 min./level.
Magic Circle against Law: As protection spells, but 10-ft. radius and 10 min./level.
NondetectionM: Hides subject from divination, scrying.
Protection from Energy: Absorb 12 points/level of damage from one kind of energy.
Phantom Steed: Magic horse appears for 1 hour/level.
Sepia Snake SigilM: Creates text symbol that immobilizes reader.
Sleet Storm: Hampers vision and movement.
Stinking Cloud: Nauseating vapors, 1 round/level.
Summon Monster III: Calls extraplanar creature to fight for you.
Arcane Sight: Magical auras become visible to you.
Clairaudience/Clairvoyance: Hear or see at a distance for 1 min./level.
Telepathic Bond, Lesser: As telepathic bond, but you and one other creature.
Tongues: Speak any language.
Deep Slumber: Puts 10 HD of creatures to sleep.
Heroism: Gives +2 bonus on attack rolls, saves, skill checks.
Hold Person: Paralyzes one humanoid for 1 round/level.
Rage: Subjects gains +2 to Str and Con, +1 on Will saves, –2 to AC.
Suggestion: Compels subject to follow stated course of action.
Daylight: 60-ft. radius of bright light.
Fireball: 1d6 damage per level, 20-ft. radius.
Lightning Bolt: Electricity deals 1d6/level damage.
Tiny Hut: Creates shelter for ten creatures.
Wind Wall: Deflects arrows, smaller creatures, and gases.
Displacement: Attacks miss subject 50%.
Illusory ScriptM: Only intended reader can decipher.
Invisibility Sphere: Makes everyone within 10 ft. invisible.
Major Image: As silent image, plus sound, smell and thermal effects.
Gentle Repose: Preserves one corpse.
Halt Undead: Immobilizes undead for 1 round/level.
Ray of Exhaustion: Ray makes subject exhausted.
Vampiric Touch: Touch deals 1d6/two levels damage; caster gains damage as hp.
Blink: You randomly vanish and reappear for 1 round/level.
Flame Arrow: Arrows deal +1d6 fire damage.
Fly: Subject flies at speed of 60 ft.
Gaseous Form: Subject becomes insubstantial and can fly slowly.
Haste: One creature/level moves faster, +1 on attack rolls, AC, and Reflex saves.
Keen Edge: Doubles normal weapon’s threat range.
Magic Weapon, Greater: +1/four levels (max +5).
Secret Page: Changes one page to hide its real content.
Shrink Item: Object shrinks to one-sixteenth size.
Slow: One subject/level takes only one action/round, –1 to AC, reflex saves, and attack rolls.
Water Breathing: Subjects can breathe underwater.